


   F   255  ,  1,   1



 NO textures/redbrick.xpm


SO   ./textures/redbrick.xpm


     
          WE textures/mossy.xpm

     EA   ./textures/greystone.xpm

     S  ./textures/pillar.xpm

         R     1300 1000


C    0  ,  1  ,  255


 111
11W1111
 111111