
NO textures/redbrick.xpm


SO   ./textures/redbrick.xpm



WE textures/mossy.xpm

EA   ./textures/greystone.xpm

F                0 ,                    255          ,             0

S  ./textures/pillar.xpm

 
C 0,0,255



R     800 500

1111111
111111
1111111

11111111111111111
10000000000000001
10200000200000201
10000000000000001 
10202020002020201
10000000000000001
10001111200200001
10001  1000000001
10201111200002001
1N000000000000001
11111111111111111


11111
11S11
11111