F                                       122         ,           122             ,           122

SO   ./textures/redbrick.xpm

     EA   ./textures/greystone.xpm

      NO textures/redbrick.xpm

                WE textures/mossy.xpm
R 1080 720





     S  ./textures/barrel.xpm



C  255,200,                                                      160


11111111111111111
10000000000000001
102000002000N0201
10000000000000001
10002000200020001
10000000000000001
10202020002020201
10000000000000001
10002000200200001
10000000000000001
10200000200002001
10000000000000001
11111111111111111